.CCCCCCCC.
FFFFFFFF..
C.CCCCCCC.
..FFFFFFFF
..CCCRCCR.
FFFFFFFFF.

E 0 1 SE
G 20 11
